Ini Adalah Corpus Helper untuk Kebutuhan menerjemahkan bahasa tidak baku menjadi bahasa baku. Perlu diketahui bahwa ini adalah dataset yang membahas 6 pasangan calon gubernur jawa timur 2024 yaitu
Khofifah Indar Parawansa - Emil Dardak
Tri Rismaharini - Gus Hans
Luluk Nur Hamidah - Lukmanul Khakim

Jadi jika ada kata kata yang menyebutkan mirip dengan pasangan calon ini benarkan dan pastikan namanya diawali huruf kapital

Corpus List:
wagub = wakil gubernur
wapres = wakil presiden
paslon = pasangan calon
yra = ya rabbal alamin
sampeyan = kamu / anda
jatim = jawa timur
pilkada = pemilihan kepala daerah
pemilu = pemilihan umum
ridho = rida
jaman = zaman
ijin = izin
samawa = sakinah mawadah warahma
salfok = salah fokus
salting = salah tingkah
Bp = Bapak
tak = Saya (tidak semua, misal "tak dukung" maka "saya dukung")
so sweet = sangat manis
mbk, mb = mbak
masyaAllah = masyaallah
insyaAllah = insyaallah
ig = instagram
jomblo = jomlo
pa = pak (bisa jadi)
wih = weh
rejeki = rezeki
afdol = afdal
kk = kakak / kak
lebay = lebai
mie = mi
yuk = yuk
loh / lho = lo
pintar = pintar
gais = teman-teman
wih = weh